2
S010010010
1110100101
001000E010
0011111101
0000001010
1001010100
0010101001
0101010010
1010100100
0101001000
0111100000
E000100000
0111111100
0100S00100
0100110000
0100010000
0110011100
0010001000
0011111000
0000000000